51111111111111111111111111111111111111111111111116
20000000000000000000000000000000000000000000000003
20000000000000000000000000000000000000000000000003
20000000000000000000000000000000000000000000000003
20000000000000000000000000000000000000000000000003
20000000000000000000000000000000000000000000000003
20000000000000000000000000000000000000000000000003
20000000000000000000000000000000000000000000000003
20000000000000000000000000000000000000000000000003
20000000000000000000000000000000000000000000000003
20000000000000000000000000000000000000000000000003
20000000000000000000000000000000000000000000000003
20000000000000000000000000000000000000000000000003
20000000000000000000000000000000000000000000000003
20000000000000000000000000000000000000000000000003
20000000000000000000000000000000000000000000000003
20000000000000000000000000000000000000000000000003
20000000000000000000000000000000000000000000000003
20000000000000000000000000000000000000000000000003
20000000000000000000000000000000000000000000000003
20000000000000000000000000000000000000000000000003
20000000000000000000000000000000000000000000000003
20000000000000000000000000000000000000000000000003
20000000000000000000000000000000000000000000000003
20000000000000000000000000000000000000000000000003
20000000000000000000000000000000000000000000000003
20000000000000000000000000000000000000000000000003
20000000000000000000000000000000000000000000000003
20000000000000000000000000000000000000000000000003
20000000000000000000000000000000000000000000000003
20000000000000000000000000000000000000000000000003
20000000000000000000000000000000000000000000000003
20000000000000000000000000000000000000000000000003
20000000000000000000000000000000000000000000000003
20000000000000000000000000000000000000000000000003
20000000000000000000000000000000000000000000000003
20000000000000000000000000000000000000000000000003
20000000000000000000000000000000000000000000000003
20000000000000000000000000000000000000000000000003
20000000000000000000000000000000000000000000000003
20000000000000000000000000000000000000000000000003
20000000000000000000000000000000000000000000000003
20000000000000000000000000000000000000000000000003
20000000000000000000000000000000000000000000000003
20000000000000000000000000000000000000000000000003
20000000000000000000000000000000000000000000000003
20000000000000000000000000000000000000000000000003
20000000000000000000000000000000000000000000000003
20000000000000000000000000000000000000000000000003
74444444444444444444444444444444444444444444444448