1831,1832,1832,1832,1832,1832,1832,1832,1832,1832,1832,1832,1832,1832,1832,1832,1832,1832,1832,1832,1832,1832,1832,1832,1832,1832,1832,1832,1832,1832,1832,1832,1832,1832,1832,1832,1832,1832,1832,1832,1832,1832,1832,1832,1832,1832,1832,1832,1832,1833
1859,1860,1833,1831,1833,1831,1833,1831,1833,1831,1833,1831,1833,1831,1833,1831,1833,1831,1833,1831,1833,1831,1833,1859,1896,1897,1861,1860,1860,1860,1833,1831,1833,1831,1833,1831,1833,1831,1833,1831,767,768,769,2028,2028,2116,2028,2091,2028,1861
1859,1887,1860,1887,1889,1887,1889,1887,1889,1887,1889,1887,1889,1887,1889,1887,1889,1887,1889,1887,1889,1887,1889,1859,1924,1925,1861,1860,1860,1860,1860,1887,1889,1887,1889,1887,1889,1887,1889,1887,767,768,769,2028,2118,2028,2028,2028,2028,1861
1859,1831,1833,1860,1833,1831,1833,1831,1833,1831,1833,1831,1833,1831,1833,1831,1833,1831,1833,1831,1833,1831,1833,1859,1896,1897,1861,1860,1860,1943,1860,1860,1833,1831,1833,1831,1833,1831,1833,1831,767,768,769,2028,2116,2028,2118,2028,2028,1861
1859,1887,1889,1887,1860,1887,1889,1887,1889,1887,1889,1860,1860,1887,1889,1887,1889,1887,1889,1887,1889,1887,1889,1859,1924,1925,1861,1860,1860,1860,1860,1860,1889,1887,1889,1887,1889,1887,1889,1887,767,768,768,740,740,740,2028,2028,2028,1861
1859,1831,1833,1831,1833,1860,1860,1860,1860,1860,1860,1831,1860,1831,1833,1831,1833,1831,1833,1831,1833,1860,1833,1859,1896,1897,1861,1860,1943,1860,1860,1860,1860,1831,1833,1831,1833,1831,1833,1831,795,773,768,768,768,768,740,2116,2028,1861
1859,1887,1889,1887,1889,1887,1860,1860,1889,1943,1889,1887,1860,1887,1889,1887,1889,1887,1889,1887,1860,1860,1889,1859,1924,1925,1861,1860,1860,1860,1974,1860,1860,1860,1889,1887,1889,1887,1889,1887,1889,795,796,796,773,768,768,2028,2028,1861
1859,1831,1833,1831,1833,1943,1860,1974,1860,1831,1833,1831,1860,1860,1833,1831,1833,1831,1833,1831,1860,1831,1833,1859,1896,1897,1861,1860,1860,1860,1860,1860,1943,1860,1860,1831,1833,1831,1833,1831,1833,1831,1833,1831,795,773,768,2028,2028,1861
1859,1887,1889,1887,1860,1860,1860,1943,1860,1860,1889,1887,1974,1860,1860,1887,1889,1887,1889,1887,1860,1887,1889,1859,1924,1925,1861,1860,1860,1974,1860,1860,1860,1860,1974,1860,1889,1887,1889,1887,1889,1887,1889,1887,1889,767,768,740,740,1861
1859,1831,1833,1831,1860,1860,1974,1860,1833,1860,1860,1943,1860,1943,1860,1860,1833,1831,1833,1860,1833,1831,1833,1859,1896,1897,1861,1860,1860,1860,1860,1860,1860,1860,1860,1860,1860,1860,1833,1831,1833,1831,1833,1831,1833,795,796,796,796,1861
1859,1887,1889,1887,1860,1887,1943,1860,1943,1860,1860,1860,1860,1943,1889,1860,1974,1860,1889,1943,1860,1887,1889,1859,1924,1925,1861,1860,1860,1860,1860,1974,1860,1860,1860,1860,1860,1860,1860,1860,1889,1887,1889,1887,1889,1887,1889,1887,1889,1861
1859,1831,1833,1831,1860,1831,1833,1860,1974,1860,1860,1860,1860,1943,1833,1860,1860,1860,1833,1860,1860,1831,1833,1859,1896,1897,1861,1860,1860,1974,1860,1974,1918,1860,1943,1860,1860,1860,1860,1860,1860,1831,1833,1831,1833,1831,1833,1831,1833,1861
1859,1887,1889,1860,1860,1860,1889,1860,1860,1860,1889,1887,1860,1943,1860,1860,1860,1860,1860,1860,1860,1887,1889,1859,1924,1925,1861,1860,1860,1860,1860,1860,1860,1860,1860,1974,1860,1943,1860,1860,1860,1887,1889,1887,1889,1887,1889,1887,1889,1861
1859,1831,1833,1860,1833,1860,1860,1860,1860,1860,1860,1860,1833,1860,1860,1943,1860,1860,1860,1860,1860,1831,1833,1859,1896,1897,1861,1943,1860,1860,1943,1860,1860,1860,1860,1860,1860,1860,1918,1860,1860,1860,1833,1831,1833,1831,1833,1831,1833,1861
1859,1887,1889,1887,1860,1860,1943,1974,1860,1887,1889,1860,1860,1860,1943,1860,1860,1860,1943,1860,1860,1860,1889,1859,1924,1925,1861,1860,1860,1860,1860,1860,1918,1860,1860,1860,1860,1860,1860,1974,1860,1860,1860,1860,1889,1887,1889,1887,1889,1861
1859,1831,1833,1831,1860,1831,1833,1860,1943,1943,1833,1831,1860,1860,1833,1831,1860,1860,1860,1943,1860,1860,1860,1859,1896,1897,1861,1860,1860,1974,1860,1860,1860,1860,1860,1860,1974,1860,1860,1860,1860,1860,1860,1974,1860,1831,1833,1831,1833,1861
1859,1887,1889,1887,1889,1887,1889,1860,1943,1943,1889,1887,1860,1887,1860,1974,1943,1860,1860,1860,1860,1943,1860,1859,1924,1925,1861,1860,1860,1860,1860,1860,1974,1860,1860,1860,1860,1943,1860,1860,1974,1860,1860,1860,1860,1860,1860,1887,1889,1861
1859,1831,1833,1831,1833,1831,1833,1860,1833,1860,1833,1860,1860,1831,1833,1860,1974,1860,1860,1860,1860,1860,1860,1859,1896,1897,1861,1860,1860,1860,1974,1860,1860,1860,1943,1974,1860,1860,1860,1860,1860,1860,1860,1943,1860,1860,1860,1860,1860,1861
1859,1887,1889,1887,1889,1887,1943,1860,1860,1860,1860,1860,1889,1887,1889,1943,1860,1860,1889,1860,1943,1860,1860,1859,1924,1925,1861,1860,1918,1860,1860,1860,1918,1860,1860,1860,1860,1974,1943,1860,1860,1974,1860,1860,1860,1943,1860,1860,1860,1861
1859,1831,1833,1831,1833,1831,1833,1860,1833,1831,1833,1831,1833,1831,1833,1943,1833,1860,1974,1860,1860,1860,1860,1859,1896,1897,1861,1860,1860,1860,1860,1860,1943,1860,1860,1860,1860,1860,1860,1860,1860,1860,1918,1943,1860,1943,1860,1860,1860,1861
1859,1887,1889,1887,1889,1887,1889,1887,1889,1887,1889,1887,1889,1887,1889,1887,1889,1887,1860,1860,1943,1860,1860,1859,1924,1925,1861,1943,1943,1860,1943,1860,1974,1860,1860,1860,1974,1860,1860,1860,1860,1974,1860,1860,1860,1860,1860,1860,1860,1861
1859,1831,1833,1831,1833,1831,1833,1831,1833,1831,1833,1831,1833,1831,1833,1831,1833,1831,1833,1860,1860,1860,1860,1859,1896,1897,1861,1860,1860,1860,1860,1943,1860,1860,1860,1860,1860,1860,1974,1860,1860,1860,1860,1860,1860,1860,1860,1943,1860,1861
1859,1887,1889,1887,1889,1887,1889,1887,1889,1887,1889,1887,1889,1887,1889,1887,1889,1887,1889,1860,1860,1860,1860,1859,1924,1925,1861,1860,1860,1860,1860,1943,1860,1860,1943,1860,1860,1860,1860,1860,1860,1943,1860,1860,1974,1860,1860,1860,1860,1861
1859,1832,1832,1832,1832,1832,1832,1832,1832,1832,1832,1832,1832,1832,1832,1832,1832,1832,1832,1832,1832,1832,1832,1835,1836,1837,1838,1832,1832,1832,1832,1832,1832,1832,1832,1832,1832,1832,1832,1832,1832,1832,1832,1832,1832,1832,1832,1832,1832,1861
1859,1896,1897,1896,1897,1896,1897,1896,1897,1896,1897,1896,1897,1896,1897,1896,1897,1896,1897,1896,1896,1896,1897,1863,1864,1865,1866,1896,1897,1896,1897,1896,1897,1896,1897,1896,1897,1896,1897,1896,1897,1896,1897,1896,1897,1896,1897,1896,1897,1861
1859,1924,1925,1924,1925,1924,1925,1924,1925,1924,1925,1924,1925,1924,1925,1924,1925,1924,1925,1924,1924,1924,1925,1891,1892,1893,1894,1924,1925,1924,1925,1924,1925,1924,1925,1924,1925,1924,1925,1924,1925,1924,1925,1924,1925,1924,1925,1924,1925,1861
1859,1888,1888,1888,1888,1888,1888,1888,1888,1888,1888,1888,1888,1888,1888,1888,1888,1888,1888,1888,1888,1888,1888,1919,1920,1921,1922,1888,1888,1888,1888,1888,1888,1888,1888,1888,1888,1888,1888,1888,1888,1888,1888,1888,1888,1888,1888,1888,1888,1861
1859,1831,1833,1831,1833,742,1833,1831,1833,1831,1833,1831,1833,1831,1833,1831,1833,1831,1833,1831,1833,1831,1833,1859,1924,1925,1861,1860,1860,1831,1833,1831,1833,1831,1833,1831,1833,1831,1833,1831,1860,1831,1833,1831,1833,1831,1833,1831,1833,1861
1859,1887,1889,1887,1889,767,741,1887,1889,1887,1889,1887,1889,1887,1889,1887,1889,1887,1889,1887,1889,1887,1889,1859,1896,1897,1861,1860,1860,1860,1889,1860,1889,1887,1889,1887,1889,1887,1889,1887,1860,1860,1860,1887,1889,1887,1889,1887,1889,1861
1859,1831,1833,1831,1833,767,768,741,1833,1860,1833,1860,1860,1860,1943,1860,1833,1831,1833,1831,1833,1831,1833,1859,1924,1925,1861,1943,1943,1860,1860,1860,1860,1831,1833,1831,1860,1860,1860,1860,1860,1860,1860,1860,1860,1860,1833,1831,1833,1861
1859,1887,1889,1887,1860,795,768,768,741,1860,1860,1860,1889,1887,1860,1860,1860,1860,1860,1887,1889,1887,1889,1859,1896,1897,1861,1860,1860,1860,1860,1887,1889,1860,1860,1860,1860,1887,1860,1860,1943,1860,1860,1860,1860,1860,1889,1860,1889,1861
1859,1831,1833,1860,1833,1860,795,768,768,741,1833,1831,1860,1860,1860,1831,1860,1860,1860,1860,1833,1831,1833,1859,1896,1897,1861,1943,1860,1860,1860,1860,1833,1831,1860,1860,1833,1860,1860,1860,1860,1860,1860,1831,1860,1860,1860,1860,1860,1861
1859,1887,1889,1860,1860,1860,1943,767,768,768,1860,1887,1889,1860,1860,1860,1860,1887,1860,1887,1860,1887,1889,1859,1924,1925,1861,1887,1860,1887,1943,1860,1860,1887,1889,1860,1860,1860,1974,1860,1860,1860,1889,1887,1860,1860,1860,1887,1860,1861
1859,1831,1833,1831,1833,1860,1860,795,768,768,741,1943,1860,1831,1860,1974,1860,1831,1943,1831,1860,1831,1833,1859,1896,1897,1861,1831,1860,1831,1860,1860,1860,1831,1833,1860,1860,1860,1860,1860,1860,1831,1833,1860,1860,1831,1860,1831,1860,1861
1859,1887,1889,1887,1889,1887,1943,1860,767,768,768,741,1860,1943,1860,1860,1860,1974,1860,1860,1860,1887,1889,1859,1924,1925,1861,1887,1889,1887,1889,1860,1860,1860,1860,1860,1889,1860,1860,1860,1860,1860,1889,1887,1860,1887,1860,1860,1889,1861
1859,1831,1833,1831,1860,1860,1833,1974,795,768,768,768,741,1943,1860,1860,1860,1860,1943,1860,1833,1831,1833,1859,1896,1897,1861,1831,1860,1860,1860,1860,1860,1860,1860,1860,1860,1943,1860,1860,1943,1860,1974,1860,1833,1860,1860,1860,1833,1861
1859,1887,1889,1887,1860,1860,1860,1943,1860,795,796,768,768,741,1889,1860,1974,1860,1889,1887,1860,1887,1889,1859,1924,1925,1861,1887,1860,1887,1860,1860,1943,1887,1889,1860,1860,1860,1860,1943,1943,1860,1860,1860,1860,1860,1860,1860,1889,1861
1859,1831,1833,1831,1860,1831,1860,1860,1860,1860,1860,795,768,768,740,741,1833,1860,1860,1831,1860,1831,1833,1859,1896,1897,1861,1831,1860,1831,1860,1860,1833,1860,1860,1860,1860,1831,1860,1860,1860,1860,1860,1943,1860,1943,1860,1831,1833,1861
1859,1887,1889,1887,1889,1860,1860,1860,1860,1860,1860,1887,795,796,768,768,740,740,741,1887,1860,1887,1889,1859,1924,1925,1861,1887,1860,1887,1860,1860,1860,1860,1860,1887,1860,1860,1860,1943,1860,1887,1974,1860,1860,1860,1860,1860,1889,1861
1859,1831,1833,1831,1833,1974,1860,1831,1943,1831,1860,1831,1860,1831,795,796,768,768,768,740,740,740,740,741,1896,1897,1861,1831,1860,1860,1860,1943,1860,1831,1860,1860,1974,1860,1860,1860,1833,1831,1860,1860,1860,1860,1860,1860,1833,1861
1859,1887,1889,1887,1889,1860,1860,1887,1860,1943,1889,1860,1860,1974,1860,1887,795,796,796,768,768,768,768,800,740,740,741,1887,1860,1887,1974,1860,1860,1887,1860,1860,1974,1860,1860,1887,1860,1887,1860,1860,1860,1860,1860,1860,1889,1861
1859,1831,1860,1860,1860,1860,1833,1860,1943,1974,1943,1860,1860,1860,1860,1943,1833,1831,1833,795,796,796,796,796,796,796,796,825,1860,1831,1860,1831,1860,1831,1860,1860,1860,1860,1860,1860,1860,1831,1860,1831,1833,1831,1860,1860,1833,1861
1859,1887,1889,1860,1889,1887,1860,1860,1860,1860,1860,1860,1943,1943,1889,1887,1943,1887,1860,1860,1889,1887,1889,1859,1924,1925,1861,1887,1889,1860,1860,1860,1860,1887,1860,1860,1943,1860,1860,1887,1860,1887,1889,1887,1889,1887,1860,1860,1889,1861
1859,1831,1833,1831,1860,1831,1833,1860,1974,1943,1860,1943,1860,1831,1833,1831,1833,1860,1860,1831,1833,1831,1833,1859,1896,1897,1861,1831,1833,1860,1860,1831,1860,1860,1943,1860,1943,1831,1833,1831,1833,1860,1833,1860,1833,1831,1860,1860,1833,1861
1859,1887,1889,1887,1889,1860,1860,1860,1860,1887,1889,1943,1860,1974,1860,1860,1860,1887,1860,1860,1889,1887,1889,1859,1924,1925,1861,1887,1889,1887,1860,1860,1860,1860,1860,1860,1889,1860,1889,1943,1889,1860,1860,1943,1889,1860,1860,1860,1889,1861
1859,1831,1833,1831,1833,1860,1860,1831,1860,1860,1860,1831,1974,1860,1860,1860,1833,1831,1974,1860,1833,1831,1833,1859,1896,1897,1861,1831,1860,1860,1860,1831,1943,1974,1833,1831,1833,1860,1860,1943,1833,1860,1860,1974,1833,1860,1833,1860,1833,1861
1859,1887,1889,1887,1889,1887,1889,1887,1889,1887,1889,1860,1889,1887,1889,1887,1889,1860,1860,1887,1889,1887,1889,1859,1924,1925,1861,1887,1860,1887,1889,1887,1860,1860,1860,1860,1860,1974,1943,1943,1860,1860,1860,1887,1860,1860,1860,1860,1889,1861
1859,1831,1833,1831,1833,1831,1833,1860,1833,1831,1860,1831,1833,1831,1833,1831,1833,1831,1833,1831,1833,1831,1833,1859,1896,1897,1861,1831,1860,1860,1860,1860,1833,1860,1860,1860,1860,1860,1860,1860,1860,1860,1860,1860,1860,1860,1833,1831,1833,1861
1859,1887,1889,1887,1889,1887,1889,1887,1860,1860,1889,1887,1889,1887,1889,1887,1889,1887,1889,1887,1889,1887,1889,1859,1924,1925,1861,1887,1889,1887,1889,1887,1889,1887,1889,1860,1889,1887,1889,1887,1889,1887,1889,1887,1889,1887,1889,1887,1889,1861
1887,1888,1888,1888,1888,1888,1888,1888,1888,1888,1888,1888,1888,1888,1888,1888,1888,1888,1888,1888,1888,1888,1888,1888,1888,1888,1888,1888,1888,1888,1888,1888,1888,1888,1888,1888,1888,1888,1888,1888,1888,1888,1888,1888,1888,1888,1888,1888,1888,1889
